228,228,228,228,228,228,228,228,228,228,228,228,228,228,228,228,228,228,228,228,228,228,228,228,228,228,228,228,228,228,228,228,
180,180,180,180,180,180,180,180,180,180,180,180,180,180,180,180,180,180,180,180,180,180,180,180,180,180,180,180,180,180,180,180,
33,33,33,33,33,33,33,33,33,33,33,33,33,33,33,33,33,33,33,33,33,33,33,33,33,33,33,33,33,33,33,33,
33,33,33,33,33,33,33,33,33,33,33,33,33,33,33,33,33,33,33,33,33,33,33,33,33,33,33,33,33,33,33,33,
180,180,180,180,180,180,180,180,180,180,180,180,180,180,180,180,180,180,180,180,180,180,180,180,180,180,180,180,180,180,180,180,
180,180,180,180,180,180,180,180,180,180,180,180,180,180,180,180,180,180,180,180,180,180,180,180,180,180,180,180,180,180,180,180,
22,22,22,22,22,22,22,22,22,22,22,22,22,22,22,22,22,22,22,22,22,22,22,22,22,22,22,22,22,22,22,22,
180,180,180,180,180,180,180,180,180,180,180,180,180,180,180,180,180,180,180,180,180,180,180,180,180,180,180,180,180,180,180,180,
161,161,161,161,161,161,161,161,161,161,161,161,161,161,161,161,161,161,161,161,161,161,161,161,161,161,161,161,161,161,161,161,
180,180,180,180,180,180,180,180,180,180,180,180,180,180,180,180,180,180,180,180,180,180,180,180,180,180,180,180,180,180,180,180,
100,100,100,100,100,100,100,100,100,100,100,100,100,100,100,100,100,100,100,100,100,100,100,100,100,100,100,100,100,100,100,100,
100,100,100,100,100,100,100,100,100,100,100,100,100,100,100,100,100,100,100,100,100,100,100,100,100,100,100,100,100,100,100,100,
6,6,6,6,6,6,6,6,6,6,6,6,6,6,6,6,6,6,6,6,6,6,6,6,6,6,6,6,6,6,6,6,
180,180,180,180,180,180,180,180,180,180,180,180,180,180,180,180,180,180,180,180,180,180,180,180,180,180,180,180,180,180,180,180,
92,92,92,92,92,92,92,92,92,92,92,92,92,92,92,92,92,92,92,92,92,92,92,92,92,92,92,92,92,92,92,92,
100,100,100,100,100,100,100,100,100,100,100,100,100,100,100,100,100,100,100,100,100,100,100,100,100,100,100,100,100,100,100,100,
100,100,100,100,100,100,100,100,100,100,100,100,100,100,100,100,100,100,100,100,100,100,100,100,100,100,100,100,100,100,100,100,
22,22,22,22,22,22,22,22,22,22,22,22,22,22,22,22,22,22,22,22,22,22,22,22,22,22,22,22,22,22,22,22,
33,33,33,33,33,33,33,33,33,33,33,33,33,33,33,33,33,33,33,33,33,33,33,33,33,33,33,33,33,33,33,33,
161,161,161,161,161,161,161,161,161,161,161,161,161,161,161,161,161,161,161,161,161,161,161,161,161,161,161,161,161,161,161,161,
228,228,228,228,228,228,228,228,228,228,228,228,228,228,228,228,228,228,228,228,228,228,228,228,228,228,228,228,228,228,228,228,
36,36,36,36,36,36,36,36,36,36,36,36,36,36,36,36,36,36,36,36,36,36,36,36,36,36,36,36,36,36,36,36,
228,228,228,228,228,228,228,228,228,228,228,228,228,228,228,228,228,228,228,228,228,228,228,228,228,228,228,228,228,228,228,228,
228,228,228,228,228,228,228,228,228,228,228,228,228,228,228,228,228,228,228,228,228,228,228,228,228,228,228,228,228,228,228,228,
100,100,100,100,100,100,100,100,100,100,100,100,100,100,100,100,100,100,100,100,100,100,100,100,100,100,100,100,100,100,100,100,
100,100,100,100,100,100,100,100,100,100,100,100,100,100,100,100,100,100,100,100,100,100,100,100,100,100,100,100,100,100,100,100,
161,161,161,161,161,161,161,161,161,161,161,161,161,161,161,161,161,161,161,161,161,161,161,161,161,161,161,161,161,161,161,161,
6,6,6,6,6,6,6,6,6,6,6,6,6,6,6,6,6,6,6,6,6,6,6,6,6,6,6,6,6,6,6,6,
22,22,22,22,22,22,22,22,22,22,22,22,22,22,22,22,22,22,22,22,22,22,22,22,22,22,22,22,22,22,22,22,
100,100,100,100,100,100,100,100,100,100,100,100,100,100,100,100,100,100,100,100,100,100,100,100,100,100,100,100,100,100,100,100,
6,6,6,6,6,6,6,6,6,6,6,6,6,6,6,6,6,6,6,6,6,6,6,6,6,6,6,6,6,6,6,6,
22,22,22,22,22,22,22,22,22,22,22,22,22,22,22,22,22,22,22,22,22,22,22,22,22,22,22,22,22,22,22,22,
33,92,180,22,33,228,36,228,92,100,228,100,161,228,92,100,36,6,22,33,161,180,92,161,36,100,100,100,33,180,228,36,
22,33,22,180,228,161,33,180,161,92,33,33,33,6,92,100,161,228,6,92,228,36,36,92,161,228,100,22,22,100,33,33,
22,36,92,22,228,100,180,92,36,100,33,22,36,92,100,92,180,92,6,36,180,36,228,22,6,161,228,22,92,36,228,36,
161,100,100,6,22,22,22,228,92,100,228,228,36,22,22,100,100,33,33,36,36,92,6,22,161,161,100,22,33,180,22,161,
36,161,228,22,161,33,161,92,36,33,180,92,100,6,180,100,33,100,6,100,180,180,180,6,180,22,6,161,100,33,36,228,
228,161,33,36,33,6,22,33,33,6,6,22,100,22,33,36,22,100,161,228,36,92,180,33,36,33,100,180,180,22,100,100,
161,6,228,180,33,33,92,228,36,92,92,33,228,100,22,228,100,228,36,100,100,161,228,22,161,161,100,92,36,22,36,36,
228,161,22,92,22,100,180,100,22,36,33,92,161,100,228,6,6,100,161,92,161,180,92,22,228,6,180,6,6,33,33,100,
22,36,180,6,33,36,6,161,6,36,33,100,6,33,180,33,228,228,228,100,33,33,180,100,22,33,161,180,180,180,6,180,
92,6,161,33,161,161,92,161,100,100,100,6,22,33,22,36,36,161,36,22,180,228,161,22,6,161,180,33,161,22,92,100,
92,92,228,228,33,161,36,180,6,6,228,33,92,100,22,161,161,100,36,161,36,22,180,161,6,228,22,92,22,22,228,180,
92,36,100,100,6,228,100,100,33,33,22,100,100,36,6,100,161,22,36,100,22,100,36,33,161,22,36,100,6,36,180,36,
36,92,36,92,161,180,161,161,33,33,161,92,180,92,33,92,22,22,22,6,33,33,36,92,228,92,228,36,180,22,36,6,
180,161,6,36,33,100,161,228,180,180,180,33,180,36,161,92,228,22,22,6,161,33,6,228,100,33,22,6,6,33,36,228,
180,36,100,100,6,22,161,100,161,180,36,33,92,33,100,180,6,161,6,92,228,36,6,22,228,6,180,228,36,22,6,228,
161,36,36,22,228,180,36,92,228,228,33,161,92,92,36,228,33,100,180,180,228,33,228,100,33,6,36,180,100,33,228,33,
92,92,228,228,228,228,161,100,6,100,100,36,36,33,180,228,228,180,180,6,180,100,228,161,92,36,6,100,161,33,33,180,
22,161,36,161,22,6,92,180,161,100,33,33,228,228,33,36,22,22,100,33,36,228,161,22,100,6,33,161,36,6,22,33,
36,36,228,33,22,100,36,180,22,92,228,228,180,92,22,33,180,161,161,228,161,228,36,92,33,33,92,100,36,161,92,33,
180,33,92,161,228,161,161,161,228,180,161,228,33,228,36,6,36,100,180,22,180,92,161,180,180,6,228,161,22,180,228,33,
33,33,228,100,6,161,6,92,180,36,100,100,6,180,92,36,22,161,92,33,100,161,92,180,92,161,6,33,180,36,92,92,
92,33,180,100,36,180,228,36,180,22,22,92,6,180,161,100,6,92,33,36,92,33,100,100,22,36,180,33,92,36,6,92,
100,33,228,161,36,228,33,92,36,161,33,92,6,22,161,92,6,228,100,180,92,180,92,180,180,22,22,36,180,161,22,6,
36,92,36,228,180,92,92,33,6,100,228,161,180,100,180,92,228,161,36,33,92,36,6,6,161,161,6,6,92,6,161,6,
6,228,180,36,100,228,92,228,161,33,92,33,36,161,6,228,36,36,161,161,33,22,22,33,228,33,100,22,180,36,22,100,
161,100,6,6,33,33,92,92,161,36,6,100,228,228,33,36,180,22,228,36,36,33,180,36,228,36,33,22,180,161,228,161,
22,161,22,180,180,6,228,228,180,6,180,161,228,228,92,92,228,161,180,180,228,180,180,33,6,100,180,33,6,36,180,161,
228,100,33,6,161,6,161,92,100,33,33,92,22,180,6,36,92,92,228,228,36,228,33,228,228,161,180,36,22,33,92,22,
180,161,22,228,36,228,161,6,100,92,228,33,180,100,100,228,180,161,180,180,22,161,161,180,22,180,36,36,6,22,180,36,
100,161,22,92,36,6,36,180,228,33,100,180,228,33,22,92,6,33,6,36,161,228,180,22,180,180,22,100,161,100,36,161,
161,228,6,180,6,33,92,33,92,161,36,100,36,180,6,33,180,6,92,22,92,180,161,228,228,33,33,161,180,36,6,100,
22,6,36,22,6,6,22,92,22,228,33,92,33,33,180,180,180,92,228,100,6,36,92,92,228,22,33,161,33,6,228,33,
